10 10
+-------+---+-------+
|       |   |       |
+-+ +-+ | + +---+ + |
|   | | | |       | |
| +-+ | | | +-----+-+
|   | | | | |       |
+-+ | | | +-+ +-+-+ |
|   | | |   |   | | |
| +-+ + +-+ +-+ | | |
| |         |   | | |
| +-----+ +-+ +-+ + |
| |     | |     |   |
| + +-+ | | +-+-+ +-+
|     | | | | |   | |
| +---+ +-+ | | +-+ |
| |   |   | | |     |
| + + | + | | +---+ |
|   | | | | |       |
+---+ | | + +-----+ |
|     | |         | |
+-----+-+---------+-+
